##@#@###
@#!#!!@#
!##!@###
!@###!!@
##!##@##
!#@###!@
@##!###!
###@!@#@