#@#####!@
#!!@#@!#!
####!###@
!###@####
@!@####@!
########!
#!@#@###@
@!##!#!##
##!@##@##