#!@#@#@#
@###!#!#
!#!@#!!@
!@###@##
#######@
!#!!@##!
@#@###@#
####@!!#